111111111111111111111111111111111111111111
10000000000000C0000000000C0000000000000001
1000C00E0000000000010000000000000000000001
100000000CCCCCCCCCC1000000000E000000011101
1000C0500000000000010000000000000000000001
100000000000111111110000000000000000E00001
110E00000000000000010000000000000000000001
1P00C00000000000000100000C0000000000000001
111111111111111111111111111111111111111111
