1111111111111111111111111111111
10000000000000C0000000000C00001
1000C000000000000P0000000000001
1000000000000000000000000000001
1000C00000000000000000000000001
1000000000001111111100000000001
1000000000000000000000000000001
100E000000000000000000000C00001
1111111111111111111111111111111
