1111111111111111111111111111111
1000000000000000000000000000001
10000000000000000P0000000000001
1000000000000000000000000000001
1000000000000000000000000000001
1000000000001111111100000000001
1000000000000000000000000000001
100E000000000000000000000C00001
1111111111111111111111111111111
