111111111111111111111111111111111111111111
100000B00000000000000000000000000000B00001
100000000000000000010000000000000000000001
10000E000000000000010000000000C00000000001
100000000000000000010000000000000000000001
10000000000011111111000000000000000B000001
110000000000000000100000000000000000000001
1P00000000000B000001000000000B000B00000001
111111111111111111111111111111111111111111
