111111111111111111111111111111111111111111
10000000000000C0000000000C0000000000000001
1000C0000000000000010000000000000000000001
10000E000CCCCCCCCCC10000000000000000011101
1000C0000000000000010000000000000000000001
100000000000111111110000000000000000000001
110000000000000000100000000000000000000001
1P00C00000000000000100000C0000000000000001
111111111111111111111111111111111111111111
