11111111111111111111111111111111111111111
10000000000000C0000000000C000000000000001
1000C00E000000000P00000000000000000000001
100000000CCCCCCCCCC000000000E000000011101
1000C000000000000000000000000000000000001
10000000000011111111000000000000000E00001
100E0000000000000000000000000000000000001
1000C00000000000000000000C000000000000001
11111111111111111111111111111111111111111
